5,5,5,5,5,5,5
5,0,0,0,3,0,4
5,3,4,4,4,0,5
5,3,4,2,4,3,5
5,3,3,4,4,0,5
5,0,3,0,0,3,5
5,5,5,5,5,1,5