5,5,5,5,5,5,5
5,0,0,0,0,0,5
5,0,4,5,4,0,5
5,0,5,2,5,0,5
5,0,4,5,4,0,5
5,0,0,0,0,0,5
5,5,5,5,5,1-1,5
はじめての一歩
2
0
