5,5,5,5,5,5,5
5,4,0,4,0,4,5
5,0,4,4,4,0,5
5,4,4,2,4,4,5
5,0,4,4,4,0,5
5,4,0,4,0,4,5
5,5,5,5,5,1-3,5
ちょっとれんしゅう
2
0
